##########E##########
#___________________#
#___________________#
#_________@_________#
#___________________#
#___________________#
#________________@__#
#___________________#
#___________________#
#____________@______#
#___________________#
#H_________________M#
##########D##########