{
"Tiles": [
"########E########",
"###____________M#",
"##______________#",
"#_______________#",
"#_______________#",
"#_______________#",
"#_______________#",
"#_______________#",
"#_______________#",
"#______________H#",
"########D########"
]
}