{
"Legend":
[
    "# is tree.",
    "_ is ground.",
    "H is health potion",
    "M is mana potion.",
    "E is entry/player spawn.",
    "D is door to exit.",
    "@ is house." 
],
"Tiles": [
"########D########",
"####___________H#",
"###_____________#",
"##______________#",
"#_______________#",
"#_______________#",
"#__@____________#",
"##_____________##",
"###_____@_____###",
"####_________####",
"########E########"
]
}