{
"Legend":
[
    "# is tree.",
    "_ is ground.",
    "H is health potion",
    "M is mana potion.",
    "E is entry/player spawn.",
    "D is door to exit."
],
"Tiles": [
"########D########",
"####___________H#",
"###_____________#",
"#_______________#",
"#_______________#",
"#_______________#",
"#_______________#",
"##______________#",
"###_____________#",
"####___________M#",
"########E########"
]
}