#####################
#___________________#
#_________@_________#
#___________________#
#___________@_______#
#___________________#
#___________________#
#___________$_______#
#___________________#
#___________________#
#___________________#
#___________________#
#####################