#####################
#__________________$#
#___________________#
#___________________#
#___________@_______#
#___________________#
#___________________#
#___________$_______#
#___@_______________#
#___________________#
#___________________#
#__________________$#
#####################