#####################
#__________________M#
#___________________#
#___________________#
#___________@_______#
#___________________#
#___________________#
#___________________#
#___@_______________#
#___________________#
#___________________#
#__________________H#
#####################