#####################
#__________________M#
#_________@_________#
#___________________#
#___________@_______#
#___________________#
#___________________#
#___________________#
#___________________#
#___________________#
#___________________#
#___________________#
#####################