##########E##########
#H_________________M#
#___________________#
#_________@_________#
#___________________#
#___________________#
#_____@_____________#
#___________________#
#___________________#
#____________@______#
#___________________#
#___________________#
##########D##########