##########E##########
#__________________M#
#______@____________#
#___________________#
#___________@_______#
#___________________#
#___@_______________#
#___________________#
#___________________#
#___________________#
#___________________#
#H__________________#
##########D##########